1111111111111111111
10000001111000011E1
100000010C100000001
1000000000000000001
1P00000000000000001
10000011110000C0001
1000000000000000001
1111111111111111111
