1111111111111111111
10000000000000000E1
100000000C000000001
1000000000000000001
1P00000000000000001
1111111111111111111
